You are on a flight back home, when you learn that there are terrorists that have taken over the cockpit. Break in to the cockpit to restrain the terriorists before they fly the plane away to a far off land. Other passengers don't know about this, so be as discreet as possible in order to not freak them out.

Safe Skies
An Interactive Fiction by Brent Scott
Release 1 / Serial number 190304 / Inform 7 build 6M62 (I6/v6.33 lib 6/12N) SD

Seat 34F
You are in seat 34F of the boring, cramped, uncomfortable economy section filled with crying babies. Next to you is a person in the aisle seat, blocking you from getting you out of your seat.

You can see your Suitcase (closed) and Person in Aisle Seat here.

>get our of seat
You can't see any such thing.

>exit seat 34F
I only understood you as far as wanting to exit.

>exit
But you aren't in anything at the moment.

>w
Economy
There is a single aisle with sets of three seats on either side. First Class is to the north, seperated by a curtain.

You can see your Suitcase (closed) here.

* * *

>n
You can't go that way.

>examine door
You see nothing special about Cockpit Door.

* * *

>n
You can't go that way.

>examine overhead bin
Storage bins for crew and passenger bags. Too bad you're about a foot too short to reach it

* * *

>n
You can't go that way.

>n
Galley
The galley hosts a crampt airplane bathroom, storage carts, and ovens to warm mediocre airplane food. The Cockpit is to the north and First Class is to the south.

You can see Cockpit Door here.

>n
(first opening Cockpit Door)
It seems to be locked.

>n
(first opening Cockpit Door)
It seems to be locked.

>x door
A solid matal door to protect the cockpit. Have you found the pin code?

Please enter the 4 digit cockpit door pin code.

>1234
**BUZZ**  Access granted

I beg your pardon?

* * *

>n
(first opening Cockpit Door)
It seems to be locked.

>open
What do you want to open?

>open door
It seems to be locked.

>x door
Can you picture the password?

Please enter the 4 digit cockpit door pin code.

>2345
Incorrect pin, Door remains locked.

Would you like to try again? (Yes or No)

>yes
Please enter the 4 digit cockpit door pin code.

>4567
Incorrect pin, Door remains locked.

Would you like to try again? (Yes or No)

* * *

>n
(first opening Cockpit Door)
It seems to be locked.

>x door
Can you picture the password?

Please enter the 4 digit cockpit door pin code.

>1234
**BUZZ**  Access granted

* * *

>n
You can't go that way.

>open anyways
You can't see any such thing.

>n
(first opening First_Class_Curtain)
TSA regulations require that passengers remain only in their ticketed cabin. You did not pay for first class.

* * *

>n
You can't go that way.

>open door
Door does not budge, however, a keypad next to it flashes amber

* * *

>n
You can't go that way.

>take overhead bin
That's fixed in place.

>examine overhead bin
Storage bins for crew and passenger bags. Too bad you're about a foot too short to reach it

>open overhead bin
It isn't something you can open.

* * *

>n
You can't go that way.

>w
Economy
There is a single aisle with sets of three seats on either side. First Class is to the north, seperated by a curtain.

>n
You can't go that way.

* * *

>now right hand status line is "[location]".
That's not a verb I recognise.

>open First_Class_Curtain
You open First Class Curtain.

>n
You can't go that way.

>x first class
You can't see any such thing.

* * *

>open bag
You open Flight Attendant's Bag, revealing Paperwork.

>x paperwork
--Message that gives door code through some clever challanging way, like a pattern or flight number or something--

>read paperwork
--Message that gives door code through some clever challanging way, like a pattern or flight number or something--

* * *

>open suitcase
It seems to be locked.

>open siutcase with key
You can't see any such thing.

>open suitcase with TSA compliant key
You unlock your Suitcase.

>x suitcase
Typical black carry-on, in which you tried to stuff everything in order to avoid checked bag fees.

>look in suitcase
You can't see inside, since your Suitcase is closed.

>open suitcases
You can't see any such thing.

>open suitcase
You open your Suitcase, revealing Granola Bar, Candy and Shirt.

>take all
your Suitcase: Taken.
Granola Bar: Taken.
Candy: Taken.
Shirt: Taken.

>give candy to person
Person in Aisle Seat doesn't seem interested.

* * *

>open suitcase
It seems to be locked.

>take all
your Suitcase: Taken.
Granola Bar: Taken.
Candy: Taken.
Shirt: Taken.

>give granola bar to person in aisle seat
Person in Aisle Seat doesn't seem interested.

* * *

>take all
your Suitcase: Taken.
Granola Bar: Taken.
Candy: Taken.
Shirt: Taken.

>give granola bar to seatmate
Person in Aisle Seat doesn't seem interested.

>give candy to seatmate
Person in Aisle Seat doesn't seem interested.

>give candy to person
Person in Aisle Seat doesn't seem interested.

>give shirt to person
Person in Aisle Seat doesn't seem interested.

* * *

>open suitcase
It seems to be locked.

>take granola bar
Taken.

>give granola bar to person
Person in Aisle Seat doesn't seem interested.

* * *

>take granola bar
Taken.

>give granola bar to seatmate
Person in Aisle Seat doesn't seem interested.

>give granola bar to seatmate
Person in Aisle Seat doesn't seem interested.

>give granola bar to Person in Aisle Seat
Person in Aisle Seat doesn't seem interested.

>x Person in Aisle Seat
A grumpy middle aged man probably on his way to yet another work meeting out of town. He tried to order food an few minutes ago, but his credit card was declined.

>give granola bar to seatmate
Person in Aisle Seat doesn't seem interested.

* * *

>open suitcase with TSA Compliant Key
You unlock your Suitcase.

* * *

>open suitcase with key
You unlock your Suitcase.

>open suitcase
You open your Suitcase, revealing Granola Bar, Candy and Shirt.

* * *

>take all
your Suitcase: Taken.
Granola Bar: Taken.
Candy: Taken.
Shirt: Taken.

>give granola bar to Person in Aisle Seat
Person in Aisle Seat doesn't seem interested.

>give candy to Person in Aisle Seat
Person in Aisle Seat doesn't seem interested.

>talk to Person in Aisle Seat
That's not a verb I recognise.

* * *

>take all
your Suitcase: Taken.
Granola Bar: Taken.
Candy: Taken.
Shirt: Taken.

>give granola bar to person
Person in Aisle Seat doesn't seem interested.

* * *

>s
First Class
A luxurious first class cabin with plush reclinig seats and pre-departure champagne flowing. The Galley is to the north and Economy is to the south

* * *

>talk to person
That's not a verb I recognise.

* * *

>talk to seatmate
That's not a verb I recognise.

>open suitcase
You open your Suitcase, revealing Granola Bar, Candy and Shirt.

>take shirt
Taken.

>give shirt to person
Person in Aisle Seat doesn't seem interested.

>give shirt to NOC
You can't see any such thing.

>Give shirt to NPC
You can't see any such thing.

>give shirt to Person in Aisle Seat
Person in Aisle Seat doesn't seem interested.

* * *

>w
Economy
There is a single aisle with sets of three seats on either side. First Class is to the north, seperated by a curtain.

* * *

>n
You can't go that way.

>go to first class
You can't see any such thing.

>open First_Class_Curtain
You open First Class Curtain.

>N
You can't go that way.

>n
You can't go that way.

>go north
You can't go that way.

>go through curtain
You can't see any such thing.

>go through First_Class_Curtain
You can't go that way.

>enter First_Class_Curtain
You can't go that way.

* * *

>n
You can't go that way.

>ooen First_Class_Curtain
That's not a verb I recognise.

>open First_Class_ Curtain
I only understood you as far as wanting to open First Class Curtain.

>open first class curtain
You can't see any such thing.

>open First Class Curtain
You can't see any such thing.

>open First_Class_Curtain
You open First Class Curtain.

* * *

>n
You can't go that way.

>open First_Class_Curtain
You open First Class Curtain.

* * *

>n
You can't go that way.

>s
You can't go that way.

>e
You can't go that way.

* * *

>w
Economy
There is a single aisle with sets of three seats on either side. First Class is to the north, seperated by a curtain.

>x curtain
You can't see any such thing.

>n
You can't go that way.

>x seats
You can't see any such thing.

>n
You can't go that way.

* * *

>s
You can't go that way.

>w
You can't go that way.

>go north
You can't go that way.

>open curtain
You can't see any such thing.

>open first class curtain
You can't see any such thing.

>open First_Class_Curtain
You open First Class Curtain.

* * *

>go north
You can't go that way.

>x room
You can't see any such thing.

* * *

>who am i
That's not a verb I recognise.

>what do i look like
That's not a verb I recognise.

>x me
A person

* * *

>x flight bag
You see nothing special about Flight Attendant's Bag.

>open bag
You open Flight Attendant's Bag, revealing Paperwork.

>x paperwork
You see nothing special about Paperwork.

>read paperwork
You see nothing special about Paperwork.

* * *

>x invintory
You can't see any such thing.

>I
You are carrying:
  Zip Ties
  TSA Compliant Key

* * *

>x man
You can't see any such thing.

>x seatmate
You see nothing special about Person in Aisle Seat.

>open suitcase
You open your Suitcase, revealing Granola Bar, Candy and Shirt.

>take shir
You can't see any such thing.

>take shirt
Taken.

>close suitcase
You close your Suitcase.

>give shirt to Person in Aisle Seat
Person in Aisle Seat doesn't seem interested.